the advantages and drawbacks	les avantages et les désavantages
alive and well	bien en vie
alive and kicking	en pleine forme
assets and liabilities	l'actif et le passif
to go back and forth	faire des allées et venues
in bits and pieces	en menus morceaux
to get board and lodging	être nourri et logé
to keep body and soul together	survivre
it is raining cats and dogs	il pleut des cordes
from the cradle to the grave	du berceau à la tombe
dead and gone	mort et enterré
to be down and out/to be down at heel	être au tapis, être sur le pavé
in dribs and drabs	petit à petit
to pay in dribs and drabs	payer au compte-gouttes
from dusk to dawn	du soir au matin
a dusk-to-dawn curfew	un couvre-feu qui dure toute la nuit
the ebb and flow	le flux et le reflux
fair and square	honnnête et franc
in fits and starts	par à-coups
through fire and water/through thick and thin	par vents et marées
the flora and fauna	la flore et la faune
the goodies and the baddies	les bons et les méchants (familier)
happy-go-lucky	insouciant
heads or tails	pile ou face
the haves and the have-nots	les riches et les pauvres
by hook or by crook	par tous les moyens, coûte que coûte
the hustle and bustle of city life	le tourbillon de la vie citadine
under lock and key	sous les verrous
null and void	nul et non avenu
odds and ends	des petits objets sans valeur
to be part and parcel of	faire partie intégrante de
the peaks and troughs of the economy	les hauts et les bas de l'économie
profits and losses	pertes et profits
the pros and cons	le pour et le contre
tit-for-that	un prété pour un rendu
topsy-turvy	sens dessus dessous
a touch-and-go situation	dont l'issue est incertaine
to pick and choose	e montrer difficile
safe and sound	sain et sauf
supply and demand	l'offre et la demande
ways and means	différents moyens
wheeling and dealing	des magouilles en affaires (péjoratif)
a wheeler-dealer	un affairiste
with might and main	avec force, de toutes ses forces