All ideas should be open to questioning, and the merit of ideas should be assessed on the strength of the evidence that supports them	Toutes les les idées doivent pouvoir être contestées, et leurs mérite doit être jugé sur la valeur des preuves sur lesquelles elles reposent
In the 19th century, some believed science would soon solve all problems, and in doing so would eliminate war	Au 19e siècle, certains croyaient que la science résoudrait bientôt tous les problémes et, ce faisant, éliminerait la guerre
The most striking thing in this great age of scientific discovery is not how much scientists know but how little	Ce qu'il y a de plus frappant à notre époque de grandes découvertes, ce n'est pas l'étendue des connaissances qu'ont les savants, mais l'étendue de leur ignorance
According to a survey, 80% of the French but on 50% of Americans agree that human beings developed from earlier species of animals	D'après un sondage, 80% des Français mais seulement 50% des Américains sont d'accord pour dire que l'être humain est issu d'espèces animales plus anciennes
There is a "paradigm shift" whenever a scientific revolution occurs	IL y a une "changement de paradigme" chaque fois qu'a lieu une révolution scientique
The Massachusets Institute of Technology (MIT) is best-known for its research into AI or aeronautics, but also economics and linguistics	L'Institut de technologie du Massachusetts (MIT) est surtout connu pour ses recherches en IA ou en aéronautique, mais aussi en écnomie et en linguistique
Whether conventional journals are still necessary in the internet age is a matter of debate	On peut se demander si les revues scientifiques traditionnelles sont encore nécessaires à l'ère d'internet
T.Edison, who registered an amazing 1,903 patents, is credited with the invention of the light bulb	On attribue à T.Edison, qui a déposé le nombre incroyable de 1903 brevets, l'invention de l'ampoule électrique
Many of world's great innovators started out as hackers-people who like to tinker with technology	Bon nombre de grands inventeurs de l'histoire ont commencé comme bricoleurs, des gens qui aiment bidouiller
Scientific evidence is often misused or distorted by politicians to justify decisions which are really based on ideological grounds	Les données scientifiques sont souvent utilisées improprement ou dénaturées par les hommes politiques pour justifier des décisions qui sont en fait fondées sur des considérations idéologiques
In spite of the knowledge accumulated in the past two decades, the behaviour of oceans is still poorly understood	Malgré les connaissances acquises depuis une vingtaine d'années, le comportement des océans est encore mal connu
Any idea must be challenged, any hypothesis must be tested	Toute idée doit être contestée, toute hypothèse doit être mise à l'épreuve
A study conducted by two psychologists at Lille University concludes this phenomenon is unlikely to happen again	Une étude menée par deux psychologues de l'université de Lille conclut qu'il est peu probable que ce phénomène se reproduise
The inventiveness of scientists may be measured by the number of patents they register	L'inventivité des scientifiques peut se mesurer au nombre de brevets qu'ils déposent
It is undeniable that the theory of relativity was a turning-point in the history of physics	Il est indéniable que la théorie de la relativité a été un tournant dans l'histoire de la physique
More and more people oppose mice being experimented on	De plus en plus de gens s'opposent à ce que l'on fasse des expériences sur des souris
Technophobia is gaining ground because of the mistakes made in the past	La technophobie gagne du terrain à cause des erreurs commises dans le passé
The process developed by this engineer is a major breakthrough	Cette technique mise au point par cet ingénieur représente une percée majeure
This technique is a direct spin-off from research into laser beams	Cette technique est directement dérivée de la recherche sur les rayons laser
This gadget has made it possible to revolutionize the way people worked up to now	Ce gadget a permis de révolutionner la façon dont on travaillait jusqu'ici