science / the sciences	la science / les sciences
exact / social sciences	les sciences exactes / sociales, humaines
hard / soft sciences	les sciences dures / molles
scientific progress	les progrès scientifiques
medical / technological advances	les progrès médicaux / technologiques
a scientist	un scientifique, un savant
the scientific community	la communauté scientifique
to be scientifically trained	avoir une formation scientifique
scientism	le scientisme
scientifically proven	prouvé scientifiquement
a learned society	une société savante
a motto	une devise
physics	la physique
a physicist	un physicien
chemistry	la chimie
a chemist	un chimiste
an astronomer	un astronome
computer science	l'informatique
a computer scientist / a computer engineer / an IT specialist	un informaticien (V1/V2/V3)
to assess	évaluer
the credentials	or affiliations	les références ou les affiliations
a recipe	une recette
knowledge	la connaissance, les connaissances, le savoir
a theory	une théorie
theoretical	théorique
a hypothesis	une hypothèse
data	des données
evidence	des preuves
to have proof of something	avoir la preuve de quelque chose
to test a theory	mettre une théorie à l'épreuve
to call a belief into question	remettre en cause une croyance
to challenge an idea / to question an idea / to dispute an idea	contester une idée
questionable / disputable	contestable
unquestionable / indisputable	incontestable
a statesman	un homme d'État
to expound	exposer
the forerunner	le précurseur
the observation of recurring phenomenal patterns	l'observation de schémas phénoménaux récurrents
research	la recherche, des recherches
to do research	faire des recherches
to carry out research into / on a subject	mener des recherches sur un sujet
cutting-edge research	la recherche de pointe
groundbreaking research	des recherches révolutionnaires
a research laboratory	un laboratoire de recherches
a researcher / a research worker	un chercheur (V1/V2)
a research fellow	un chercheur attaché à une université
a research student	un étudiant de doctorat, un doctorant
the funds	la finance
its director and board	comité directeur
basic/fundamental / applied research	la recherche fondamentale (V1,V2) / appliquée
findings	des conclusions, des résultats
a discovery	une découverte
a breakthrough	une percée
a study	une étude
to conduct a study	mener, réaliser une étude
a paper	un article
a journal	une revue scientifique
a scholar	un érudit
an academic	un universitaire
the general public	le grand public
an experiment	une expérience
a phenomenon / phenomena	un phénomène / des phénomènes
to carry out an experiment / to conduct an experiment / to make an experiment	faire une expérience (V1/V2/V3)
to experiment on mice	expérimenter sur des souris
to experiment with a new vaccine	expérimenter un nouveau vaccin
a laboratory / a lab	un laboratoire
a guinea pig	un cobaye
to obtain a tenured position	se faire titulariser
research and development	recherche et développement
to develop	mettre au point, élaborer
to try out a technique	essayer, faire l'essai d'une technique
to devise	concevoir
a device	un appareil, un dispositif, un mécanisme
to design	concevoir, élaborer
a prototype	un prototype
a model	un modèle, une maquette
a blueprint	un plan, un projet
paradigm shifts	changements de paradigme
inquiry	questionnement
the heaping up	l'accumulation
technique	technique
technology	technologiques
technical	technique
a technician	un technicien
a technicality	un détail technique OU une difficulté, un ennui technique
a science park / a science and technology park / a research park / a technology park	un technopole
the technorati	les gens qui ont une compétence technique
a technophobe	un technophobe
technophobic	technophobe
technophobia / technofear	la technophobie
technocracy	la technocratie
in cotton mills	dans les filatures de coton
a weaver	un tisserand
a knitting machine	une machine à tricoter
to improve	améliorer
to upgrade	mettre à jour
to revolutionize	révolutionner
a revolutionary technique	une technique révolutionnaire
a patent	un brevet
to innovate	innover
an innovation	une innovation
an inventor	un inventeur
inventive / creative	inventif / créatif
inventiveness / creativity	l'inventivité / la créativité
to act as a pioneer	faire oeuvre de pionnier
pioneer work	un travail pionnier, novateur
to pioneer the study of something	être l'un des premiers à étudier quelque chose
to register a patent	déposer un brevet
the electric light bulb	l'ampoule électrique
an engine	un moteur
an engineer	un ingénieur
engineering	l'ingénierie, le génie
civil engineering	le génie civil
robotics	la robotique
electronics	l'électronique
mechanics	la mécanique
mechanical	mécanique
a mechanism	un mécanisme
machinery	les machines, la machinerie
to operate a system	faire fonctionner un système
unassailable	inattaquable
secondhand smoke	le tabagisme passif
a magic wand	une baguette magique
equipment	le matériel
a gadget	un gadget
gadgetry	des gadgets
a gizmo	un machin, un truc
hi-tech	hi-tech
state-of-the-art	dernier cri
to be tech-savvy	être calé en matière de technologiques
to fit	adapter
to flip the switch	allumer
But getting there	mais pour y arriver
sleek	aux lignes pures
to lug	trimballer
a mobile phone / a cell phone	un téléphone portable (V1/V2)
a wireless device	un appareil sans fil
a smartphone	un téléphone intelligent
a touch-screen	un écran tactile
a MP3 player	un lecteur MP3
a sensor	un capteur
to brew	se préparer
to be upended	être chamboulé
upheaval	un bouleversement
to come across	paraître
to churn out	produire en masse
to usher in	introduire