stifling	étouffant
ashamed	avoir honte
abysmal	épouvantable
faint-hearted	peureux
dreary	triste, morne
tight-lipped	muet (dans le sens refusé de parler)
inescapable	inéluctable
clunky	maladroit
witty	plein d'esprit, spirituel
wisecracking	blagueur
wrecked	(complètement) détruit
dire	désastreux
daunting	intimidant
thankless	ingrat
unyielding	inflexible/inébranlable
elusive	insaisissable
scheming	intrigant
leafy	feuillu
mind-blowing	hallucinant
straightforward	facile, simple
subtle	subtil