Yo: haría, Tú: harías, Él/Ella: haría, Nosotros: haríamos, Vosotros: haríais, Ellos/Ellas: harían	faire
Yo: vería, Tú: verías, Él/Ella: vería, Nosotros: veríamos, Vosotros: veríais, Ellos/Ellas: verían	voir
Yo: tendría, Tú: tendrías, Él/Ella: tendría, Nosotros: tendríamos, Vosotros: tendríais, Ellos/Ellas: tendrían	avoir
Yo: sería, Tú: serías, Él/Ella: sería, Nosotros: seríamos, Vosotros: seríais, Ellos/Ellas: serían	être
Yo: estaría, Tú: estarías, Él/Ella: estaría, Nosotros: estaríamos, Vosotros: estaríais, Ellos/Ellas: estarían	être (état)
Yo: iría, Tú: irías, Él/Ella: iría, Nosotros: iríamos, Vosotros: iríais, Ellos/Ellas: irían	aller
Yo: diría, Tú: dirías, Él/Ella: diría, Nosotros: diríamos, Vosotros: diríais, Ellos/Ellas: dirían	dire
Yo: sabría, Tú: sabrías, Él/Ella: sabría, Nosotros: sabríamos, Vosotros: sabríais, Ellos/Ellas: sabrían	savoir
Yo: querría, Tú: querrías, Él/Ella: querría, Nosotros: querríamos, Vosotros: querríais, Ellos/Ellas: querrían	vouloir
Yo: daría, Tú: darías, Él/Ella: daría, Nosotros: daríamos, Vosotros: daríais, Ellos/Ellas: darían	donner
Yo: podría, Tú: podrías, Él/Ella: podría, Nosotros: podríamos, Vosotros: podríais, Ellos/Ellas: podrían	pouvoir
Yo: llevaría, Tú: llevarías, Él/Ella: llevaría, Nosotros: llevaríamos, Vosotros: llevaríais, Ellos/Ellas: llevarían	porter
Yo: pasaría, Tú: pasarías, Él/Ella: pasaría, Nosotros: pasaríamos, Vosotros: pasaríais, Ellos/Ellas: pasarían	passer
Yo: pondría, Tú: pondrías, Él/Ella: pondría, Nosotros: pondríamos, Vosotros: pondríais, Ellos/Ellas: pondrían	mettre
Yo: dejaría, Tú: dejarías, Él/Ella: dejaría, Nosotros: dejaríamos, Vosotros: dejaríais, Ellos/Ellas: dejarían	laisser
Yo: hablaría, Tú: hablarías, Él/Ella: hablaría, Nosotros: hablaríamos, Vosotros: hablaríais, Ellos/Ellas: hablarían	parler
Yo: saldría, Tú: saldrías, Él/Ella: saldría, Nosotros: saldríamos, Vosotros: saldríais, Ellos/Ellas: saldrían	sortir
Yo: miraría, Tú: mirarías, Él/Ella: miraría, Nosotros: miraríamos, Vosotros: miraríais, Ellos/Ellas: mirarían	regarder
Yo: viviría, Tú: vivirías, Él/Ella: viviría, Nosotros: viviríamos, Vosotros: viviríais, Ellos/Ellas: vivirían	vivre
Yo: encontraría, Tú: encontrarías, Él/Ella: encontraría, Nosotros: encontraríamos, Vosotros: encontraríais, Ellos/Ellas: encontrarían	trouver
Yo: trabajaría, Tú: trabajarías, Él/Ella: trabajaría, Nosotros: trabajaríamos, Vosotros: trabajaríais, Ellos/Ellas: trabajarían	travailler
Yo: llamaría, Tú: llamarías, Él/Ella: llamaría, Nosotros: llamaríamos, Vosotros: llamaríais, Ellos/Ellas: llamarían	appeler
Yo: sentiría, Tú: sentirías, Él/Ella: sentiría, Nosotros: sentiríamos, Vosotros: sentiríais, Ellos/Ellas: sentirían	sentir
Yo: creería, Tú: creerías, Él/Ella: creería, Nosotros: creeríamos, Vosotros: creeríais, Ellos/Ellas: creerían	croire
Yo: pensaría, Tú: pensarías, Él/Ella: pensaría, Nosotros: pensaríamos, Vosotros: pensaríais, Ellos/Ellas: pensarían	penser
Yo: escribiría, Tú: escribirías, Él/Ella: escribiría, Nosotros: escribiríamos, Vosotros: escribiríais, Ellos/Ellas: escribirían	écrire
Yo: abriría, Tú: abrirías, Él/Ella: abriría, Nosotros: abriríamos, Vosotros: abriríais, Ellos/Ellas: abrirían	ouvrir
Yo: cerraría, Tú: cerrarías, Él/Ella: cerraría, Nosotros: cerraríamos, Vosotros: cerraríais, Ellos/Ellas: cerrarían	fermer
Yo: comería, Tú: comerías, Él/Ella: comería, Nosotros: comeríamos, Vosotros: comeríais, Ellos/Ellas: comerían	manger
Yo: bebería, Tú: beberías, Él/Ella: bebería, Nosotros: beberíamos, Vosotros: beberíais, Ellos/Ellas: beberían	boire
Yo: sacaría, Tú: sacarías, Él/Ella: sacaría, Nosotros: sacaríamos, Vosotros: sacaríais, Ellos/Ellas: sacarían	sortir
Yo: metería, Tú: meterías, Él/Ella: metería, Nosotros: meteríamos, Vosotros: meteríais, Ellos/Ellas: meterían	mettre
Yo: volvería, Tú: volverías, Él/Ella: volvería, Nosotros: volveríamos, Vosotros: volveríais, Ellos/Ellas: volverían	revenir
Yo: quedaría, Tú: quedarías, Él/Ella: quedaría, Nosotros: quedaríamos, Vosotros: quedaríais, Ellos/Ellas: quedarían	rester
Yo: entendería, Tú: entenderías, Él/Ella: entendería, Nosotros: entenderíamos, Vosotros: entenderíais, Ellos/Ellas: entenderían	comprendre
Yo: conocería, Tú: conocerías, Él/Ella: conocería, Nosotros: conoceríamos, Vosotros: conoceríais, Ellos/Ellas: conocerían	connaître
Yo: parecería, Tú: parecerías, Él/Ella: parecería, Nosotros: pareceríamos, Vosotros: pareceríais, Ellos/Ellas: parecerían	sembler
Yo: seguiría, Tú: seguirías, Él/Ella: seguiría, Nosotros: seguiríamos, Vosotros: seguiríais, Ellos/Ellas: seguirían	suivre
Yo: subiría, Tú: subirías, Él/Ella: subiría, Nosotros: subiríamos, Vosotros: subiríais, Ellos/Ellas: subirían	monter
Yo: bajaría, Tú: bajarías, Él/Ella: bajaría, Nosotros: bajaríamos, Vosotros: bajaríais, Ellos/Ellas: bajarían	descendre
Yo: quitaría, Tú: quitarías, Él/Ella: quitaría, Nosotros: quitaríamos, Vosotros: quitaríais, Ellos/Ellas: quitarían	enlever
Yo: empezaría, Tú: empezarías, Él/Ella: empezaría, Nosotros: empezaríamos, Vosotros: empezaríais, Ellos/Ellas: empezarían	commencer
Yo: acabaría, Tú: acabarías, Él/Ella: acabaría, Nosotros: acabaríamos, Vosotros: acabaríais, Ellos/Ellas: acabarían	finir
Yo: buscaría, Tú: buscarías, Él/Ella: buscaría, Nosotros: buscaríamos, Vosotros: buscaríais, Ellos/Ellas: buscarían	chercher
Yo: esperaría, Tú: esperarías, Él/Ella: esperaría, Nosotros: esperaríamos, Vosotros: esperaríais, Ellos/Ellas: esperarían	attendre
Yo: recordaría, Tú: recordarías, Él/Ella: recordaría, Nosotros: recordaríamos, Vosotros: recordaríais, Ellos/Ellas: recordarían	se souvenir
Yo: olvidaría, Tú: olvidarías, Él/Ella: olvidaría, Nosotros: olvidaríamos, Vosotros: olvidaríais, Ellos/Ellas: olvidarían	oublier
Yo: traería, Tú: traerías, Él/Ella: traería, Nosotros: traeríamos, Vosotros: traeríais, Ellos/Ellas: traerían	apporter
Yo: leería, Tú: leerías, Él/Ella: leería, Nosotros: leeríamos, Vosotros: leeríais, Ellos/Ellas: leerían	lire
Yo: contaría, Tú: contarías, Él/Ella: contaría, Nosotros: contaríamos, Vosotros: contaríais, Ellos/Ellas: contarían	raconter
Yo: cambiaría, Tú: cambiarías, Él/Ella: cambiaría, Nosotros: cambiaríamos, Vosotros: cambiaríais, Ellos/Ellas: cambiarían	changer
Yo: dormiría, Tú: dormirías, Él/Ella: dormiría, Nosotros: dormiríamos, Vosotros: dormiríais, Ellos/Ellas: dormirían	dormir
Yo: despertaría, Tú: despertarías, Él/Ella: despertaría, Nosotros: despertaríamos, Vosotros: despertaríais, Ellos/Ellas: despertarían	réveiller
Yo: correría, Tú: correrías, Él/Ella: correría, Nosotros: correríamos, Vosotros: correríais, Ellos/Ellas: correrían	courir
Yo: jugaría, Tú: jugarías, Él/Ella: jugaría, Nosotros: jugaríamos, Vosotros: jugaríais, Ellos/Ellas: jugarían	jouer
Yo: ganaría, Tú: ganarías, Él/Ella: ganaría, Nosotros: ganaríamos, Vosotros: ganaríais, Ellos/Ellas: ganarían	gagner
Yo: perdería, Tú: perderías, Él/Ella: perdería, Nosotros: perderíamos, Vosotros: perderíais, Ellos/Ellas: perderían	perdre
Yo: pagaría, Tú: pagarías, Él/Ella: pagaría, Nosotros: pagaríamos, Vosotros: pagaríais, Ellos/Ellas: pagarían	payer
Yo: recibiría, Tú: recibirías, Él/Ella: recibiría, Nosotros: recibiríamos, Vosotros: recibiríais, Ellos/Ellas: recibirían	recevoir
Yo: moriría, Tú: morirías, Él/Ella: moriría, Nosotros: moriríamos, Vosotros: moriríais, Ellos/Ellas: morirían	mourir
Yo: nacería, Tú: nacerías, Él/Ella: nacería, Nosotros: naceríamos, Vosotros: naceríais, Ellos/Ellas: nacerían	naître
Yo: aprendería, Tú: aprenderías, Él/Ella: aprendería, Nosotros: aprenderíamos, Vosotros: aprenderíais, Ellos/Ellas: aprenderían	apprendre
Yo: enseñaría, Tú: enseñarías, Él/Ella: enseñaría, Nosotros: enseñaríamos, Vosotros: enseñaríais, Ellos/Ellas: enseñarían	enseigner
Yo: ayudaría, Tú: ayudarías, Él/Ella: ayudaría, Nosotros: ayudaríamos, Vosotros: ayudaríais, Ellos/Ellas: ayudarían	aider
Yo: serviría, Tú: servirías, Él/Ella: serviría, Nosotros: serviríamos, Vosotros: serviríais, Ellos/Ellas: servirían	servir
Yo: usaría, Tú: usarías, Él/Ella: usaría, Nosotros: usaríamos, Vosotros: usaríais, Ellos/Ellas: usarían	utiliser
Yo: necesitaría, Tú: necesitarías, Él/Ella: necesitaría, Nosotros: necesitaríamos, Vosotros: necesitaríais, Ellos/Ellas: necesitarían	avoir besoin
Yo: gustaría, Tú: gustarías, Él/Ella: gustaría, Nosotros: gustaríamos, Vosotros: gustaríais, Ellos/Ellas: gustarían	plaire