Yo: haya hecho, Tú: hayas hecho, Él/Ella: haya hecho, Nosotros: hayamos hecho, Vosotros: hayáis hecho, Ellos/Ellas: hayan hecho	faire
Yo: haya visto, Tú: hayas visto, Él/Ella: haya visto, Nosotros: hayamos visto, Vosotros: hayáis visto, Ellos/Ellas: hayan visto	voir
Yo: haya tenido, Tú: hayas tenido, Él/Ella: haya tenido, Nosotros: hayamos tenido, Vosotros: hayáis tenido, Ellos/Ellas: hayan tenido	avoir
Yo: haya sido, Tú: hayas sido, Él/Ella: haya sido, Nosotros: hayamos sido, Vosotros: hayáis sido, Ellos/Ellas: hayan sido	être
Yo: haya estado, Tú: hayas estado, Él/Ella: haya estado, Nosotros: hayamos estado, Vosotros: hayáis estado, Ellos/Ellas: hayan estado	être
Yo: haya ido, Tú: hayas ido, Él/Ella: haya ido, Nosotros: hayamos ido, Vosotros: hayáis ido, Ellos/Ellas: hayan ido	aller
Yo: haya dicho, Tú: hayas dicho, Él/Ella: haya dicho, Nosotros: hayamos dicho, Vosotros: hayáis dicho, Ellos/Ellas: hayan dicho	dire
Yo: haya sabido, Tú: hayas sabido, Él/Ella: haya sabido, Nosotros: hayamos sabido, Vosotros: hayáis sabido, Ellos/Ellas: hayan sabido	savoir
Yo: haya querido, Tú: hayas querido, Él/Ella: haya querido, Nosotros: hayamos querido, Vosotros: hayáis querido, Ellos/Ellas: hayan querido	vouloir
Yo: haya dado, Tú: hayas dado, Él/Ella: haya dado, Nosotros: hayamos dado, Vosotros: hayáis dado, Ellos/Ellas: hayan dado	donner
Yo: haya podido, Tú: hayas podido, Él/Ella: haya podido, Nosotros: hayamos podido, Vosotros: hayáis podido, Ellos/Ellas: hayan podido	pouvoir
Yo: haya llevado, Tú: hayas llevado, Él/Ella: haya llevado, Nosotros: hayamos llevado, Vosotros: hayáis llevado, Ellos/Ellas: hayan llevado	porter
Yo: haya pasado, Tú: hayas pasado, Él/Ella: haya pasado, Nosotros: hayamos pasado, Vosotros: hayáis pasado, Ellos/Ellas: hayan pasado	passer
Yo: haya puesto, Tú: hayas puesto, Él/Ella: haya puesto, Nosotros: hayamos puesto, Vosotros: hayáis puesto, Ellos/Ellas: hayan puesto	mettre
Yo: haya dejado, Tú: hayas dejado, Él/Ella: haya dejado, Nosotros: hayamos dejado, Vosotros: hayáis dejado, Ellos/Ellas: hayan dejado	laisser
Yo: haya hablado, Tú: hayas hablado, Él/Ella: haya hablado, Nosotros: hayamos hablado, Vosotros: hayáis hablado, Ellos/Ellas: hayan hablado	parler
Yo: haya salido, Tú: hayas salido, Él/Ella: haya salido, Nosotros: hayamos salido, Vosotros: hayáis salido, Ellos/Ellas: hayan salido	sortir
Yo: haya mirado, Tú: hayas mirado, Él/Ella: haya mirado, Nosotros: hayamos mirado, Vosotros: hayáis mirado, Ellos/Ellas: hayan mirado	regarder
Yo: haya vivido, Tú: hayas vivido, Él/Ella: haya vivido, Nosotros: hayamos vivido, Vosotros: hayáis vivido, Ellos/Ellas: hayan vivido	vivre
Yo: haya encontrado, Tú: hayas encontrado, Él/Ella: haya encontrado, Nosotros: hayamos encontrado, Vosotros: hayáis encontrado, Ellos/Ellas: hayan encontrado	trouver
Yo: haya trabajado, Tú: hayas trabajado, Él/Ella: haya trabajado, Nosotros: hayamos trabajado, Vosotros: hayáis trabajado, Ellos/Ellas: hayan trabajado	travailler
Yo: haya llamado, Tú: hayas llamado, Él/Ella: haya llamado, Nosotros: hayamos llamado, Vosotros: hayáis llamado, Ellos/Ellas: hayan llamado	appeler
Yo: haya sentido, Tú: hayas sentido, Él/Ella: haya sentido, Nosotros: hayamos sentido, Vosotros: hayáis sentido, Ellos/Ellas: hayan sentido	sentir
Yo: haya creído, Tú: hayas creído, Él/Ella: haya creído, Nosotros: hayamos creído, Vosotros: hayáis creído, Ellos/Ellas: hayan creído	croire
Yo: haya pensado, Tú: hayas pensado, Él/Ella: haya pensado, Nosotros: hayamos pensado, Vosotros: hayáis pensado, Ellos/Ellas: hayan pensado	penser
Yo: haya escrito, Tú: hayas escrito, Él/Ella: haya escrito, Nosotros: hayamos escrito, Vosotros: hayáis escrito, Ellos/Ellas: hayan escrito	écrire
Yo: haya abierto, Tú: hayas abierto, Él/Ella: haya abierto, Nosotros: hayamos abierto, Vosotros: hayáis abierto, Ellos/Ellas: hayan abierto	ouvrir
Yo: haya cerrado, Tú: hayas cerrado, Él/Ella: haya cerrado, Nosotros: hayamos cerrado, Vosotros: hayáis cerrado, Ellos/Ellas: hayan cerrado	fermer
Yo: haya comido, Tú: hayas comido, Él/Ella: haya comido, Nosotros: hayamos comido, Vosotros: hayáis comido, Ellos/Ellas: hayan comido	manger
Yo: haya bebido, Tú: hayas bebido, Él/Ella: haya bebido, Nosotros: hayamos bebido, Vosotros: hayáis bebido, Ellos/Ellas: hayan bebido	boire
Yo: haya sacado, Tú: hayas sacado, Él/Ella: haya sacado, Nosotros: hayamos sacado, Vosotros: hayáis sacado, Ellos/Ellas: hayan sacado	sortir
Yo: haya metido, Tú: hayas metido, Él/Ella: haya metido, Nosotros: hayamos metido, Vosotros: hayáis metido, Ellos/Ellas: hayan metido	mettre
Yo: haya vuelto, Tú: hayas vuelto, Él/Ella: haya vuelto, Nosotros: hayamos vuelto, Vosotros: hayáis vuelto, Ellos/Ellas: hayan vuelto	revenir
Yo: haya quedado, Tú: hayas quedado, Él/Ella: haya quedado, Nosotros: hayamos quedado, Vosotros: hayáis quedado, Ellos/Ellas: hayan quedado	rester
Yo: haya entendido, Tú: hayas entendido, Él/Ella: haya entendido, Nosotros: hayamos entendido, Vosotros: hayáis entendido, Ellos/Ellas: hayan entendido	comprendre
Yo: haya conocido, Tú: hayas conocido, Él/Ella: haya conocido, Nosotros: hayamos conocido, Vosotros: hayáis conocido, Ellos/Ellas: hayan conocido	connaître
Yo: haya parecido, Tú: hayas parecido, Él/Ella: haya parecido, Nosotros: hayamos parecido, Vosotros: hayáis parecido, Ellos/Ellas: hayan parecido	sembler
Yo: haya seguido, Tú: hayas seguido, Él/Ella: haya seguido, Nosotros: hayamos seguido, Vosotros: hayáis seguido, Ellos/Ellas: hayan seguido	suivre
Yo: haya subido, Tú: hayas subido, Él/Ella: haya subido, Nosotros: hayamos subido, Vosotros: hayáis subido, Ellos/Ellas: hayan subido	monter
Yo: haya bajado, Tú: hayas bajado, Él/Ella: haya bajado, Nosotros: hayamos bajado, Vosotros: hayáis bajado, Ellos/Ellas: hayan bajado	descendre
Yo: haya quitado, Tú: hayas quitado, Él/Ella: haya quitado, Nosotros: hayamos quitado, Vosotros: hayáis quitado, Ellos/Ellas: hayan quitado	enlever
Yo: haya empezado, Tú: hayas empezado, Él/Ella: haya empezado, Nosotros: hayamos empezado, Vosotros: hayáis empezado, Ellos/Ellas: hayan empezado	commencer
Yo: haya acabado, Tú: hayas acabado, Él/Ella: haya acabado, Nosotros: hayamos acabado, Vosotros: hayáis acabado, Ellos/Ellas: hayan acabado	finir
Yo: haya buscado, Tú: hayas buscado, Él/Ella: haya buscado, Nosotros: hayamos buscado, Vosotros: hayáis buscado, Ellos/Ellas: hayan buscado	chercher
Yo: haya esperado, Tú: hayas esperado, Él/Ella: haya esperado, Nosotros: hayamos esperado, Vosotros: hayáis esperado, Ellos/Ellas: hayan esperado	attendre
Yo: haya recordado, Tú: hayas recordado, Él/Ella: haya recordado, Nosotros: hayamos recordado, Vosotros: hayáis recordado, Ellos/Ellas: hayan recordado	se souvenir
Yo: haya olvidado, Tú: hayas olvidado, Él/Ella: haya olvidado, Nosotros: hayamos olvidado, Vosotros: hayáis olvidado, Ellos/Ellas: hayan olvidado	oublier
Yo: haya traído, Tú: hayas traído, Él/Ella: haya traído, Nosotros: hayamos traído, Vosotros: hayáis traído, Ellos/Ellas: hayan traído	apporter
Yo: haya leído, Tú: hayas leído, Él/Ella: haya leído, Nosotros: hayamos leído, Vosotros: hayáis leído, Ellos/Ellas: hayan leído	lire
Yo: haya contado, Tú: hayas contado, Él/Ella: haya contado, Nosotros: hayamos contado, Vosotros: hayáis contado, Ellos/Ellas: hayan contado	raconter
Yo: haya cambiado, Tú: hayas cambiado, Él/Ella: haya cambiado, Nosotros: hayamos cambiado, Vosotros: hayáis cambiado, Ellos/Ellas: hayan cambiado	changer
Yo: haya dormido, Tú: hayas dormido, Él/Ella: haya dormido, Nosotros: hayamos dormido, Vosotros: hayáis dormido, Ellos/Ellas: hayan dormido	dormir
Yo: haya despertado, Tú: hayas despertado, Él/Ella: haya despertado, Nosotros: hayamos despertado, Vosotros: hayáis despertado, Ellos/Ellas: hayan despertado	réveiller
Yo: haya corrido, Tú: hayas corrido, Él/Ella: haya corrido, Nosotros: hayamos corrido, Vosotros: hayáis corrido, Ellos/Ellas: hayan corrido	courir
Yo: haya jugado, Tú: hayas jugado, Él/Ella: haya jugado, Nosotros: hayamos jugado, Vosotros: hayáis jugado, Ellos/Ellas: hayan jugado	jouer
Yo: haya ganado, Tú: hayas ganado, Él/Ella: haya ganado, Nosotros: hayamos ganado, Vosotros: hayáis ganado, Ellos/Ellas: hayan ganado	gagner
Yo: haya perdido, Tú: hayas perdido, Él/Ella: haya perdido, Nosotros: hayamos perdido, Vosotros: hayáis perdido, Ellos/Ellas: hayan perdido	perdre
Yo: haya pagado, Tú: hayas pagado, Él/Ella: haya pagado, Nosotros: hayamos pagado, Vosotros: hayáis pagado, Ellos/Ellas: hayan pagado	payer
Yo: haya recibido, Tú: hayas recibido, Él/Ella: haya recibido, Nosotros: hayamos recibido, Vosotros: hayáis recibido, Ellos/Ellas: hayan recibido	recevoir
Yo: haya muerto, Tú: hayas muerto, Él/Ella: haya muerto, Nosotros: hayamos muerto, Vosotros: hayáis muerto, Ellos/Ellas: hayan muerto	mourir
Yo: haya nacido, Tú: hayas nacido, Él/Ella: haya nacido, Nosotros: hayamos nacido, Vosotros: hayáis nacido, Ellos/Ellas: hayan nacido	naître
Yo: haya aprendido, Tú: hayas aprendido, Él/Ella: haya aprendido, Nosotros: hayamos aprendido, Vosotros: hayáis aprendido, Ellos/Ellas: hayan aprendido	apprendre
Yo: haya enseñado, Tú: hayas enseñado, Él/Ella: haya enseñado, Nosotros: hayamos enseñado, Vosotros: hayáis enseñado, Ellos/Ellas: hayan enseñado	enseigner
Yo: haya ayudado, Tú: hayas ayudado, Él/Ella: haya ayudado, Nosotros: hayamos ayudado, Vosotros: hayáis ayudado, Ellos/Ellas: hayan ayudado	aider
Yo: haya servido, Tú: hayas servido, Él/Ella: haya servido, Nosotros: hayamos servido, Vosotros: hayáis servido, Ellos/Ellas: hayan servido	servir
Yo: haya usado, Tú: hayas usado, Él/Ella: haya usado, Nosotros: hayamos usado, Vosotros: hayáis usado, Ellos/Ellas: hayan usado	utiliser
Yo: haya necesitado, Tú: hayas necesitado, Él/Ella: haya necesitado, Nosotros: hayamos necesitado, Vosotros: hayáis necesitado, Ellos/Ellas: hayan necesitado	avoir besoin
Yo: haya gustado, Tú: hayas gustado, Él/Ella: haya gustado, Nosotros: hayamos gustado, Vosotros: hayáis gustado, Ellos/Ellas: hayan gustado	plaire