to let the dog loose	lâcher son chien
to be at a loose end	ne pas savoir que faire
to cut loose	couper les amarres
a loose belt	une ceinture desserrée
loose discipline	relâchée, peu stricte
a loose translation / interpretation	libre, approximative
to lead a loose life	mener une vie dissolue
to lose	perdre
to be lost at sea	être perdu en mer
to lose interest in	se désintéresser de
a loss	une perte
to sell at a loss	vendre à perte
job losses	des pertes d’emploi
to be at a loss	être perplexe
to be at a loss for words	ne pas trouver ses mots
the mainstream	le courant de pensée dominant
to be in the mainstream of politics	suivre la tendance politique générale
to live outside the mainstream of society, to live on the margins of society	vivre en marge de la société
to maintain	1. maintenir / 2. soutenir (une opinion)
maintenance	l’entretien
to matter	importer
a matter	une question
It is a matter of time	c’est une question de temps
it’s no laughing matter	ce n’est pas drôle
a matter of life and death	une question de vie ou de mort
to meet	1. rencontrer / 2. être conforme à
a meeting	une réunion, une assemblée
a mess	un désordre, une pagaille
to be in a mess	être sens dessus dessous
to get oneself in a mess	se mettre dans de beaux draps
to mess about	faire des bêtises
to mess up a situation, a plan	semer la pagaille, tout gâcher
messy	désordonné
a milestone	un tournant (fig.), un événement marquant
to mislead	induire en erreur
misleading	qui induit en erreur, déroutant
a moot point	un point discutable
to move	1. bouger, remuer / 2. déménager
a move	une mesure
to be on the move	être en mouvement, en marche
a need	un besoin, une obligation
to be badly in need of food	avoir un besoin urgent de nourriture
to supply somebody’s needs	subvenir aux besoins de quelqu’un
to need	avoir besoin de
the needy	les indigents, les nécessiteux
a notice	une annonce
at a moment’s notice	tout de suite, sans préavis
at short notice	peu de temps à l’avance
until further notice	jusqu’à nouvel ordre
to be given one’s notice	recevoir un préavis de licenciement
to give one’s notice	donner sa démission
noticeable	perceptible, sensible
to occur	avoir lieu, se produire
an occurrence	un événement
an outlook	une perspective
to outnumber	surpasser en nombre
output	la production
to overtake	dépasser
to overcome	dépasser, venir à bout de
overwhelming	écrasant, renversant
to own	1. posséder / 2. reconnaître
to own oneself defeated	s’avouer vaincu
an owner	propriétaire
ownership	la propriété
to perform	exécuter, accomplir
to perform a part / a piece of music	interpréter un rôle / un morceau de musique
a performance	1. une interprétation. 2. une performance / une prestation
a pitfall	un piège
to plague	faire souffrir, harceler
a plague	un fléau
plain	1. quelconque, ordinaire / 2. évident, simple
to prevail over…	prévaloir, l’emporter sur
to prevail on somebody to do something	persuader quelqu’un de faire quelque chose
prevalent	dominant, répandu
