an appliance, a domestic appliance 	 un appareil ménager
to approve/to approve of 	 approuver…
an area 	 une zone, un domaine, une région
an argument 	 1. une dispute. 2. un argument
to assault 	 agresser
an assault 	 une agression
aggravated assault 	 coups et blessures
an asset 	 un atout, un point fort
the assets of a firm 	 l’actif
Assets and liabilities 	 l’actif et le passif
to assume 	 supposer
To assume a responsibility 	 assumer une responsabilité
an assumption 	 une supposition, une hypothèse
asylum 	 un asile
political asylum 	 l’asile politique
to claim asylum 	 demander l’asile politique
a lunatic asylum 	 un asile d’aliénés
to attempt 	 tenter, essayer
attempted murder 	 tentative d’assassinat
attempted theft 	 tentative de vol
attempted escape 	 tentative d’évasion
an attempt 	 une tentative
available 	 disponible
the average 	 la moyenne
on average 	 en moyenne
above / below average 	 au-dessus / en dessous de la moyenne
to avoid 	 éviter
avoidable/unavoidable 	 adjectif
aware 	 conscient
the awareness 	 la prise de conscience ; la sensibilisation
to be awash with, to be flooded with 	 être inondé de
awkward 	 maladroit, embarrassant
the balance 	 l’équilibre
the balance of powers 	 le rapport de forces
a bankruptcy 	 une banqueroute
To go bankrupt 	 faire banqueroute
to bargain 	 négocier, marchander
a bargain 	 une affaire
to bar 	 1. barrer, obstruer / 2. exclure
bar/barring 	 à l’exception de
a barrier 	 une barrière
a trade barrier 	 une barrière douanière
to believe 	 croire
a belief 	 une croyance
to betray 	 trahir
a betrayal 	 une trahison
to bet 	 parier
a bet 	 un pari
a bid 	 une enchère, une offre
a bill 	 1. une facture, une note / 2. un projet de loi
the black market 	 le marché noir
bleak 	 sombre, morne
a blow 	 un coup, un coup rude
a blow-up 	 une explosion
to benefit from 	 profiter de
a benefit 	 un avantage
a profit 	 un bénéfice
unemployment benefit 	 allocation-chômage
sickness benefit 	 prestations de l’assurance-maladie
to give someone the benefit of the doubt 	 le bénéfice du doute
to blackmail 	 faire du chantage
blatant 	 flagrant
