to smear 	 souiller la réputation de quelqu’un, calomnier
to sneak 	 dénote toujours une action faite de manière furtive
soap 	 du savon
to soar 	 monter en flèche
sobering 	 qui donne à réflechir
solvent 	 solvable
to spew 	 cracher, déverser
spill, an oil spill, spillage 	 une marée noire
a spin-off 	 un produit dérivé, un avantage inattendu
to spin out, to prolong 	 faire durer, faire traîner
to sponge off someone 	 vivre aux crochets de…
a sponge 	 une éponge
a sponger 	 un parasite
to spur, to stimulate 	 aiguillonner, encourager
spurious 	 faux, fallacieux
a squabble 	 une querelle
to squeeze 	 compresser ; pressurer
a squeeze 	 un manque de place, une cohue
to stab 	 poignarder
to stagger 	 tituber, chanceler
stamina 	 énergie, endurance
a stampede 	 une débâcle, une déroute, un sauve-qui-peut
staunch, dependable, loyal 	 dévoué, loyal
a staunch friend 	 un ami dévoué
a staunch supporter of democracy 	 un ardent défenseur de la démocratie
staunchness 	 loyauté, fermeté
stiff 	 raide
to keep a stiff upper lip 	 garder son flegme, rester impassible
to be bored stiff 	 s’ennuyer à mourir
to be scared stiff 	 mourir de trouille
to strangle 	 étrangler. maintenir dans un étau
to stroll 	 flâner
to stumble, to stagger 	 trébucher
a stunt 	 une cascade
a stuntman 	 un cascadeur
a publicity stunt 	 un coup de pub
to be stymied 	 être dans l’impasse.
a sunrise industry 	 une industrie d’avenir
a sunset industry 	 une industrie sur le déclin
supercilious 	 hautain, méprisant
surrogate 	 substitut
a surrogate mother 	 une mère porteuse
to swap 	 échanger, troquer
a swap 	 un échange, un troc
sweet 	 doux, sucré
to smell sweet 	 sentir bon
to sweeten 	 adoucir
to tamper (with) 	 toucher à, mettre son nez dans, trafiquer
to tape 	 enregistrer sur bande ou vidéo
a tape-recorder 	 un magnétophone
to tease 	 taquiner
tedious, boring 	 ennuyeux
to teem 	 grouiller
a think tank 	 un groupe de réflexion
tenuous 	 ténu
thrifty 	 économe
thriftless 	 dépensier
the throes 	 les affres
to be in the throes of death 	 être à l’agonie
to tilt 	 pencher
to tinker with, to tamper with 	 bricoler
to topple 	 renverser
to defile 	 salir, souiller, profaner
to march, to parade 	 défiler
diminutive 	 minuscule, tout petit
a short name 	 un diminutif
a director 	 un directeur, un metteur en scène
to discharge 	 renvoyer, licencier, libérer, démobiliser
discretion 	 1. discretion, retenue. 2. liberté d’action. 3. discernement, prudence
disgrace 	 honte, déshonneur
disfavour 	 disgrâce
definitely 	 certainement
definitely not 	 absolument pas
definitively, permanently 	 définitivement
a degree 	 un diplôme, un degré
to delay 	 retarder, différer
to mix 	 délayer
to deliver 	 1. livrer, distribuer. 2. délivrer, sauver. 3. prononcer (discours). 4. accoucher
to demand 	 exiger, réclamer
to ask 	 demander
to demonstrate 	 expliquer, manifester
a demonstrator 	 un manifestant
a deputy 	 un adjoint, un remplaçant
to deride 	 tourner en dérision, tourner en ridicule
to deserve 	 mériter
to dig up, to uproot 	 déterrer
to deter 	 dissuader, décourager
a device 	 1. un appareil. 2. un procédé, un stratagème
an estimate 	 un devis
to devise 	 imaginer, inventer, concevoir
dilapidated 	 délabré
to dispose of 	 se débarrasser de
a dispute 	 discussion, débat, conflit, différent
