to queue (up), to stand in line 	 faire la queue
to quote 	 citer
a quoted company 	 une société cotée en Bourse
a quotation 	 une citation
Quotation marks 	 des guillemets
rampage 	 se déchaîner
random 	 aléatoire, au hasard
to answer at random 	 au hasard
to range from… to… 	 aller de… à…
a range 	 une gamme, un éventail
a rank 	 un rang, un classement
the rank and file 	 la base
to rank 	 se classer
to rape 	 violer
A rapist 	 un violeur
rape 	 le colza
to rate, to assess 	 évaluer
A rate 	 un taux
The birth-rate 	 le taux de natalité
to reap 	 récolter
you reap what you have sown 	 vous récoltez ce que vous avez semé
to recede 	 s’éloigner, s’évanouir
recession 	 recul, régression, récession
a recipe 	 une recette
a recipient 	 le bénéficiaire, le destinataire
redundancy 	 licenciement, suppression d’emplois
to refrain from 	 s’abstenir de, se retenir de…
to refund 	 rembourser
a refund 	 un remboursement
to refurbish 	 remettre à neuf, retaper
a relationship 	 une relation
to release 	 1. publier, faire sortir / 2. libérer
a release 	 une libération, une sortie
to relent 	 se laisser fléchir
relentless 	 impitoyable
to relinquish, to waive, to give up 	 abandonner, renoncer à
to relocate 	 (se) réimplanter, (se) délocaliser
reluctance 	 réticence
reluctant 	 peu disposé à, peu enclin à
to rely on 	 compter sur
reliable 	 fiable, digne de confiance
to remain 	 rester
remote 	 éloigné, isolé
a remote control 	 une télécommande
to rent 	 louer
Rent 	 le loyer
a representative 	 un représentant
to rescue 	 sauver
a rescue 	 un sauvetage
to resent something 	 être contrarié par/protester contre…
resentment 	 ressentiment, rancune
resentful 	 plein de rancœur
a reservation 	 une réserve
to have reservations 	 avoir des réserves, des doutes
to resign 	 démissionner
a resignation 	 une démission
to resolve to… 	 se décider à…
to resort to… 	 avoir recours à…
as a last resort 	 en dernier ressort
in every respect 	 de tous les points de vue
to be in sore need of 	 avoir grandement besoin
a sore point 	 un point délicat (fig.)
to be in a sorry state 	 en piteux état
a sorry sight 	 un spectacle affligeant
a sound move 	 une action sensée
to be sound asleep 	 profondément endormi
the staple diet 	 la nourriture de base
a staple commodity 	 produit de base
the stark truth 	 la vérité telle qu’elle est
it is stark folly 	 de la folie pure
to be stark mad 	 fou à lier
to be in stark contrast with 	 contraster violemment
stark naked 	 nu comme un ver
state-of-the-art technology 	 dernier cri
a steady rise 	 une augmentation régulière
to be bored stiff 	 s’ennuyer à mourir
to be scared stiff 	 avoir une peur bleue
a stiff opposition 	 une féroce opposition
a stinging defeat 	 une défaite cuisante
stone deaf 	 sourd comme un pot
strictly forbidden 	 strictement interdit
a stringent measure/stringent regulations 	 une mesure sévère, des règles sévères
a substantial increase/decrease 	 sensible
a sworn enemy 	 un ennemi juré
a tall tale 	 une histoire à dormir debout
as thick as a brick 	 bête comme ses pieds
thick and fast 	 à la pelle
a thorough knowledge 	 une connaissance approfondie
to take a tough line with somebody 	 adopter une attitude de fermeté
a tough choice 	 un choix difficile
a two-tier society 	 une société à deux vitesses
an unbridgeable gap 	 un fossé insurmontable
an upward trend 	 une tendance à la hausse
a downward trend 	 une tendance à la baisse
upward mobility 	 ascension sociale
upwardly mobile 	 à mobilité sociale ascendante, promis au succès social
vastly expensive 	 extrêmement cher
a wet blanket 	 un rabat-joie
a widespread idea, opinion 	 très répandue
wrong 	 to go wrong 
to be wrong 	 avoir tort
what’s wrong? qu’est-ce qui ne va pas ?	
a yawning gap 	 une brèche béante (fig.), un large fossé
