a hardliner 	 un extrémiste pur et dur
a harbour 	 un port, un refuge, un hâvre
to harbour 	 héberger, garder
to harbour fear, hopes, suspicions 	 entretenir, nourrir
hardship 	 souffrances, épreuves
hardships 	 des privations
hardware 	 quincaillerie, matériel informatique, matériel militaire
a harvest 	 une moisson, une récolte
a haven 	 un refuge, un havre
a tax haven 	 un paradis fiscal
the head 	 la tête
from head to toe/from head to foot 	 de la tête aux pieds
to be heading for, to move towards 	 aller vers
health 	 la santé
healthy 	 sain
heat 	 la chaleur
heaven 	 le ciel, le paradis
the heyday, the golden age 	 l’âge d’or
to hike 	 faire des randonnées
to hitch-hike 	 faire de l’auto-stop
a hint 	 une allusion
to hint at 	 faire allusion à…
to hire 	 1. emprunter, louer. 2. embaucher
to hire and fire 	 système (américain) qui consiste à embaucher puis à licencier
to hit 	 frapper
to be hard-hit 	 être durement touché
a hit-list 	 une liste noire
HIV-positive 	 séropositif
a home 	 un foyer
the Home Office 	 le ministère de l’Intérieur (au Royaume-Uni)
the Home Secretary 	 le ministre de l’Intérieur britannique
the homeless 	 les sans-abri
a hollow 	 un creux
hollow 	 vide, creux
to beat hollow 	 battre à plates coutures
a hostage 	 un otage
hot 	 chaud
to be in hot water 	 être dans le pétrin
a hot tip 	 un tuyau sûr
hot air 	 du blablabla
a hotline 	 un numéro vert
a hotbed of social unrest 	 un foyer d’agitation sociale
to hover 	 1. planer au-dessus de / 2. hésiter
to be hovering between life and death 	 être entre la vie et la mort.
a hunter 	 un chasseur
a head hunter 	 un chasseur de têtes
a man hunt 	 une chasse à l’homme
he is hunting for a job 	 il est à la recherche d’un travail
to hush 	 faire taire
a deadly hush 	 un silence de mort
hush-money 	 le pot-de-vin que l’on donne pour acheter le silence de quelqu’un
to hype up 	 gonfler artificiellement, faire mousser
to ignore 	 ne pas tenir compte de
an imbalance 	 un déséquilibre
a trade imbalance 	 un déséquilibre commercial
to impair 	 détériorer
impaired health/eyesight 	 une santé détériorée, une vue abîmée
impending 	 imminent
to imply 	 impliquer
to impoverish 	 appauvrir
Impoverishment 	 appauvrissement
an incentive 	 un encouragement
income 	 des revenus
income tax 	 impôt sur le revenu
inconsistent 	 incohérent
Inconsistency 	 l’incohérence
industrial action 	 un mouvement revendicatif
an industrialist 	 un industriel
to throw down a challenge 	 jeter un défi
to throw off 	 se libérer de, enlever
to throw out 	 jeter, mettre au rebut, expulser
to throw up 	 lancer en l’air/vomir
to turn down 	 décliner une offre/refuser un candidat
to turn into 	 convertir, transformer, se transformer en…
to turn on/off 	 allumer, éteindre une lumière
to turn up/down 	 augmenter, baisser le volume
to turn up 	 arriver à l’improviste
to turn out 	 vider, évincer/tourner, prendre tournure/s’avérer
to wait for somebody/something 	 attendre
to wait on somebody 	 servir quelqu’un
to wash up 	 faire la vaisselle
to wear away 	 disparaître graduellement
to wear out 	 user, s’user
to work out a problem 	 résoudre un problème
to be worn out 	 être épuisé (person)
