to struggle 	 lutter, se battre
a struggle 	 une lutte, une bagarre
an armed struggle 	 une lutte armée
the class struggle 	 la lutte des classes
the struggle for life 	 la lutte pour la vie
to stun 	 abasourdir, assommer
to be stunned, flabbergasted 	 être stupéfait
subsequent 	 ultérieur
to subscribe 	 s’abonner à…
a subscription 	 un abonnement
to subside 	 diminuer, se calmer
a subsidy 	 une subvention
the suburbs 	 la banlieue
a suburban town 	 une ville de banlieue
suburbia 	 les banlieues résidentielles
to succeed 	1. réussir, 2. succéder
to sue someone 	 poursuivre en justice
to suffer from… 	 souffrir de…
to suit 	 convenir à
to summon 	 convoquer
a surgeon 	 un chirurgien
surgery 	 1. le cabinet d’un médecin. 2. la chirurgie
to surmise 	 présumer, conjecturer
to surrender 	 se rendre
a surrender 	 une reddition
to surround 	 entourer
the surroundings 	 l’environnement, le cadre de vie, le milieu
to survive 	 survivre
a survivor 	 un survivant
to sway 	 influencer, avoir une action déterminante
sway 	 l’influence, le pouvoir
to swear 	1. jurer, 2. dire des jurons
to swear an oath 	 prêter serment
to sweat 	transpirer
to teach 	 enseigner
to sweat workers 	 exploiter des travailleurs
a sweat-shop 	 un atelier où l’on exploite les ouvriers
a taste 	 un goût
to sweep 	 balayer
sweeping 	 vaste, de grande envergure
to swindle 	 escroquer, arnaquer
to switch 	 changer
a tabloid 	 un journal à sensation
the tabloids 	 la presse à grand tirage
to take over 	 prendre la relève, remplacer
a takeover 	 un rachat
talks 	 des pourparlers, des négociations
he has had a taste of prison 	 il a tâté de la prison
a tap 	 un robinet
to tap 	 puiser dans les ressources, exploiter
to tap somebody’s phone 	 mettre quelqu’un sur écoute
to tear 	 déchirer
a task 	 une tâche
to subsidize 	 subventionner
a tear	 une larme
to tell 	 dire, raconter
a telling-off 	 une engueulade
telltale 	 révélateur
to tempt 	 tenter
a tenant 	 un locataire
to tend 	 1. avoir tendance à…,2. soigner, entretenir
tense 	 tendu
to testify 	 témoigner, déclarer sous serment
to thank 	 remercier
thanks to… 	 grâce à…
thankful 	 reconnaissant
thankless 	 ingrat
to talk tough 	 durcir le ton
to talk through one’s hat 	 raconter n’importe quoi
to teeter on the brink of… 	 être au bord de…
to tell the difference 	 distinguer, faire la différence
to tighten the noose 	 resserrer l’étau 
a noose 	 un noeud-coulant
to tighten one’s belt 	 se serrer la ceinture (fig.)
to toe the line 	 se ranger sur la ligne de départ
to turn a blind eye to 	 fermer les yeux sur, faire semblant d’ignorer
to trigger (off) a reaction, a revolt 	 déclencher
to undergo a change, a crisis, difficulties 	 subir
to wear thin 	 être usé jusqu’à la trame
to win hands down 	 gagner haut-la-main
to wreak havoc 	 faire des ravages
an accident/an event 	 to occur, to happen, to take place
an agreement 	 to come to, to conclude, to reach, to work out, to carry out/to break, to violate
aid 	 to provide, to offer
an aim 	 to achieve, to reach
anger, violence, a revolt 	 to flare up, to break out, to boil over, to fire up
an attack 	 to launch, to carry out, to lead, to spearhead
authority 	 to wield, to exercise, to demonstrate, to defy, to undermine, to establish
a balance 	 to strike a balance (établir un équilibre), to recover one’s balance,to lose one’s balance, to upset the balance, to throw something off balance
a bargain 	 to drive a bargain, to strike
a battle 	 to wage (mener), fight, win, lose a battle, to join battle
a belt 	 to fasten one’s belt, to buckle one’s belt, to tighten one’s belt
a benefit 	 to reap a benefit/to draw a benefit from…/to give someone the benefit of the doubt
a bill 	 un projet de loi
