to have a bent for languages 	 avoir le don des langues
to follow one’s bent 	 suivre son penchant
to be bent on doing something 	 être décidé absolument
a big shot 	 un gros bonnet, un grand ponte, une huile
a blackleg 	 un briseur de grève
a blemish 	 une tache, une souillure, une honte
a blessing 	 une aubaine
a blockade 	 un blocus
a blockbuster 	 un film/un livre à grand succès
a blueprint 	 un avant-projet
a blunder 	 une gaffe, une bavure
bogus 	 faux, bidon
bogus asylum-seekers 	 des faux demandeurs d’asile
to bolster 	 soutenir
a bone 	 un os
a bone of contention 	 une pomme de discorde
a bond 	 un bon, un titre
the bond market 	 le marché obligataire
a buoyant market 	 un marché actif, porteur
to bury 	 enterrer
to bury the hatchet 	 enterrer la hache de guerre
to be buried in one’s work 	 être plongé dans son travail
a buzz word 	 une expression à la mode
a by-election 	 une élection partielle
to bypass 	 contourner
a bystander 	 un spectateur (dans la rue)
a boundary 	 une limite, une frontière
a bout 	 une crise, une poussée
a breach 	 une rupture
a breach of trust 	 un abus de confiance
breathtaking 	 palpitant
broke 	 fauché, sans le sou
a broker (Stock Exchange) 	 un courtier
a buffer 	 un butoir, un tampon
A buffer zone 	 une zone tampon
a bull 	 un taureau
to bully 	 persécuter, maltraiter
to bully somebody into doing something 	 contraindre quelqu’un par la menace à faire quelque chose
to bungle, to botch 	 rater, bousiller
a bungled job/a botched job 	 un travail bâclé
to bust/to go bust, to go bankrupt 	 faire faillite
to be bust, to be broke 	 être fauché
to canvas 	 faire du démarchage électoral ; solliciter des votes
to canvas opinions 	 sonder l’opinion
to capsize 	 se renverser, chavirer
to cater for 	1. pourvoir aux besoins de… / 2. satisfaire, répondre à
a caretaker 	 un concierge, un gardien
a caretaker government 	 un gouvernement provisoire
the ceiling 	 le plafond
a chart 	 un graphique/une courbe
to chastise, to castigate 	 fustiger, critiquer sévèrement
cheeky 	 impertinent
a chore 	 une corvée
a class 	 un cours
to skip classes 	 sécher les cours
a cliffhanger 	 une situation à suspense/un moment d’angoisse
a climax 	 un apogée, un point culminant
clumsy 	 maladroit
coarse 	 grossier, ordinaire
to call someone’s bluff 	 mettre quelqu’un au pied du mur
to call the tune 	 commander, avoir le dernier mot, donner le ton
to dig one’s own grave 	 creuser sa propre tombe
to fish for compliments 	 chercher les compliments
to have a finger in every pie 	 se mêler de tout
to have several irons in the fire 	 avoir deux fers au feu/avoir plusieurs affaires en train
to have a soft spot for… 	 avoir un faible pour…
to have a bone to pick with someone 	 avoir un compte à régler avec quelqu’un
to hit the nail on the head 	 mettre dans le mille, faire mouche
it has had its day 	 cela a fait son temps
it sells like hot cakes 	 cela se vend comme des petits pains
if I were in your shoes 	 si j’étais à ta place, si j’étais toi
to jump on the bandwagon 	 prendre le train en marche
to jump out of the frying pan into the fire 	 aller de Charybde en Scylla (sauter de la poële dans le feu)
to keep a low profile 	 garder un profil bas, ne pas se faire remarquer, filer doux
to keep an eye on/to keep tabs on 	 surveiller
to keep someone at bay 	 tenir quelqu’un à distance
to keep the pot boiling 	 arriver à s’en sortir financièrement
to keep one’s fingers crossed 	 serrer les pouces
to keep up with the Joneses 	 vouloir faire aussi bien que le voisin
that’s another kettle of fish 	 c’est une autre paire de manches
to kick the bucket 	 casser sa pipe
to kill two birds with one stone 	 faire d’une pierre deux coups
to kill the goose that lays the golden eggs 	 tuer la poule (l’oie !) aux œufs d’or
to lead up a blind alley 	 mener à une impasse
to leave someone in the lurch 	 laisser tomber quelqu’un
to let the cat out of the bag 	 vendre la mèche
that set the cat among the pigeons 	 ça a été le pavé dans la mare
to make hay while the sun shines 	 profiter du bon moment, battre le fer tant qu’il est chaud (faire le foin quand le soleil brille)
to make a clean breast of something 	 dire ce qu’on a sur le cœur
that’s a hard nut to crack 	 c’est dur à avaler…
