to be on a par with 	 à égalité avec
parole 	 liberté conditionnelle
to be on parole 	 être en liberté conditionnelle
to peddle 	 colporter
to peddle gossip 	 colporter des ragots
to peddle ideas 	 propager
to peddle drugs 	 faire du trafic de drogue
a peddlar 	 un colporteur, un camelot
a peer 	 un pair
a pet 	 un animal familier
petty 	 mineur, insignifiant
Petty jobs 	 des petits boulots
a petty offense 	 un délit mineur
the pill 	 la pillule (contraceptive)
a PIN number 	 un numéro de code personnel
to be in the pipeline, to be under way 	 être en route, être en attente
a plea 	 un appel
to enter a plea of guilty 	 plaider coupable
a plea for mercy 	 une demande de grâce
a ploy 	 un stratagème
to poach 	 braconner
a poacher 	 un braconnier
to pore over 	 étudier de près
to pore over a book 	 être absorbé par…
posh 	 chic, bon chic bon genre
a predicament 	 une situation difficile
the premises 	 les locaux
preposterous 	 absurde
a prescription 	 une ordonnance
a prey 	 une proie
to probe into 	 sonder, fouiller
a probe 	 une sonde
a space probe 	 une sonde spatiale
to prosecute 	 poursuivre en justice
a prosecutor 	 un procureur
a witness for the prosecution 	 un témoin à charge
to prop up 	 soutenir, étayer
to protract 	 faire traîner en longueur
proxy 	 procuration
a publisher 	 un éditeur
a publishing company 	 une maison d’édition
a pundit 	 un expert, un spécialiste
a board of pundits 	 un comité d’experts
a puppet 	 une marionnette
to purport to be… 	 se faire passer pour
to puzzle 	 rendre perplexe
to puzzle over something 	 essayer de comprendre
a puzzle 	 une énigme, un casse-tête
Puzzling 	 bizarre, étonnant, troublant
a quack 	 un charlatan
a quagmire 	 un bourbier
a quandary 	 un dilemme
a quarter 	 un trimestre (civil)
a term 	 un trimestre scolaire ou universitaire
at close quarters 	 de très près
to quash 	 annuler, écraser
questionable 	 contestable
queer 	 étrange, louche, suspect
to quibble 	 ergoter
ramshackle 	 délabré, qui tombe en ruine
to ransack 	 saccager, piller
a ransom 	 une rançon
to rape 	 violer
to violate the law 	 violer la loi
rape 	 1. un viol. 2. du colza
the rat race 	 la course à la réussite, la foire d’empoigne
the rear 	 l’arrière
the rear legs 	 les pattes arrière
to fight a rearguard action 	 mener un combat d’arrière-garde
to rebuke, to take to task 	 réprimander
red tape 	 la paperasserie administrative
remedial courses, lessons 	 des cours de rattrapage
a reprieve 	 un sursis, une remise d’exécution
to reshuffle 	 faire un remaniement ministériel
a reshuffle 	 un remaniement ministériel
to revamp 	 retaper
to revamp a dilapidated house 	 retaper une maison délabrée
to revamp a company, to streamline 	 réorganiser
candid, candour 	 franc, sincère/franchise, sincérité
Candide 	 naive
a case 	 une caisse, une mallette, une affaire, une cause, des arguments
casual 	 désinvolte
a cellar 	 une cave
a casual meeting 	 une rencontre décontactée
a casual remark 	 une remarque faite en passant
a cave 	 une grotte, une caverne
to take a chance 	 prendre un risque
chance 	 le hasard, une occasion
a change 	 un changement
change 	 de la petite monnaie
to charge 	 1. accuser. 2. faire payer
luck 	 la chance
fortunately 	 par chance
a chemist 	 1. un chimiste. 2. un pharmacien
a coin 	 une pièce de monnaie
a corner 	 un coin
a collaborator 	 un collabo (pendant la guerre)
to load 	 charger
a colleague, a contributor 	 un collaborateur
college 	 institut universitaire, faculté, une université
comfort 	 1. réconfort, consolation. 2. confort
a commodity 	 une matière première, un produit
comprehensive 	 exhaustif, complet, global
understanding 	 compréhensif
