a warlord 	 un seigneur de la guerre
to warn	 mettre en garde, avertir
a warning 	 un avertissement, une mise-en-garde
to warrant 	 mériter, justifier
to waste (energy, money) 	 gaspiller
to waste time 	 perdre du temps
waste 	 les déchets
waste disposal 	 le traitement des déchets
wastage 	 le gaspillage
a watershed 	 un tournant critique, un moment historique
a wave 	 une vague
a way 	 un chemin, une voie
to be under way 	 être en cours
to pave the way for… 	 ouvrir la voie à
weak 	 faible
a weak point / spot 	 un point faible
a weakness 	 une faiblesse
to weaken 	 s’affaiblir, fléchir
to wear out 	 s’user, user
weary 	 las, fatigué
to welcome 	 accueillir
welfare 	 le système de protection sociale
the Welfare State 	 l’État-providence
to whitewash 	 dissimuler la vérité
wholesale 	 sur une vaste échelle, en masse
a wholesale dealer 	 un grossiste
wholesome, healthy 	 sain, salubre
widespread 	 vaste, étendu, largement répandu
a widow 	 une veuve
a widower 	 un veuf
to wield 	 exercer un pouvoir
wisdom 	 la sagesse
the received wisdom 	 l’opinion la plus répandue
conventional wisdom has it that… 	 selon l’opinion générale…
wilderness 	 la jungle, une région sauvage
to be in the wilderness 	 traverser un désert politique (fig.)
wide-ranging 	 étendu, de grande envergure
wishful thinking 	 des voeux pieux
this is wishful thinking 	 tu prends tes rêves pour des réalités
to withdraw 	 se retirer, retirer
a withdrawal 	 un retrait
to withstand 	 résister à
to wonder 	 s’étonner, se demander
the seven wonders of the world 	 les 7 merveilles du monde
a wonder 	 un miracle
a workaholic 	 un forcené du travail
the workforce 	 les effectifs d’une entreprise
a workshop 	 un atelier
to worship 	 vénérer, adorer
the worship of money/of fame 	 le culte de l’argent/de la célébrité
worthwhile 	 qui en vaut la peine
a wound 	 une blessure
a wreck 	 une épave
to wreck 	 détruire
wretched 	 misérable
wrongful arrest 	 une arrestation arbitraire
a wrongdoer 	 un malfaiteur
wrongful 	 injustifié
a wrongful dismissal 	 un licenciement abusif
youth 	 la jeunesse
a yuppie 	 un jeune cadre dynamique
zeal 	 zèle, ferveur, fanatisme
a zealot 	 un fanatique religieux
zealotry 	 fanatisme
