a dump 	 un tas, un amas d’ordures
to dump rubbish 	 déverser
to dump goods 	 écouler des marchandises à bas prix
to dwell 	 résider, demeurer
city-dwellers 	 les citadins
country-dwellers 	 les habitants de la campagne
cave-dwellers 	 les habitants des cavernes
to dwell on… 	 insister sur… s’étendre sur…
a dwelling 	 une résidence, un logement (terme administratif)
to dwindle 	 diminuer, décroître
eager 	 empressé
to earn 	 gagner
to ease 	 réduire, soulager
the East 	 l’Orient
The Middle-East 	 le Moyen-Orient
The Near-East 	 le Proche-Orient
the Far-East 	 l’Extrême-Orient
Eastern Europe 	 l’Europe de l’Est
an earthquake 	 un tremblement de terre
the elderly 	 les personnes du troisième âge
to embody 	 incarner
an embodiment 	 une incarnation
to emphasize, to lay emphasis on 	 mettre l’accent sur
to endorse 	 endosser
the endorsement, the approval 	 l’approbation
to enhance 	 accroître
to entertain 	 distraire, amuser
an entertainment 	 une distraction
entertaining 	 divertissant
to eradicate 	 éradiquer, éliminer
to escalate 	 augmenter
an escalation 	 escalade, intensification
an estate 	 une propriété
A housing estate 	 1. un lotissement / 2. un programme immobilier
A council estate 	 une cité HLM
an estate agent 	 un agent immobilier
real estate 	 l’immobilier
to estimate 	 estimer
an estimate 	 une estimation, un devis
At a rough estimate 	 grosso modo
estimated 	 estimé
an ethical issue 	 un problème d’éthique
Ethics 	 l’éthique
eventual 	 final
evidence 	 des preuves
an evil 	 un fléau
the lesser of two evils 	 le moindre mal
an executive 	 un cadre
A junior executive 	 un cadre moyen
A senior executive 	 un cadre supérieur
A chief executive officer 	 un directeur général
to exhaust 	 épuiser
an exhaust pipe 	 un pot d’échappement
Exhaust fumes 	 des gaz d’échappement
exhausting 	 fatigant, épuisant
an exhausting job 	 un travail épuisant
an exhibition 	 une exposition
to expand 	 développer, se développer
expenditure 	 les dépenses
Government expenditure 	 les dépenses publiques
expenses 	 les frais
facilities 	 des équipements, des installations
the faith 	 la foi
faithful 	 fidèle
to fake 	 1. faire semblant, simuler / 2. truquer, falsifier
a fake 	 un faux
fake 	 faux, bidon
to fall off 	 diminuer, décroître
to pass over 	 omettre, négliger
to play down/to downplay 	 minimiser
to pull apart 	 démonter, mettre en pièces
to pull away 	 s’ébranler, démarrer (vehicle)
to pull down 	 baisser/démolir, abattre
to pull in 	 arriver (train)
to pull off 	 enlever
to pull on 	 mettre, enfiler
to pull over 	 se ranger, se garer sur le côté
to pull through 	 s’en tirer, s’en sortir
to pull oneself together 	 se ressaisir, se reprendre
to pull up 	 s’arrêter
to pull up one’s roots 	 larguer ses amarres, se déraciner
to put aside 	 économiser
to put away 	 ranger/mettre de côté, économiser
to put back 	 remettre
to put down 	 reposer quelque chose à sa place/écraser une révolte/inscrire, noter
to put forward 	 avancer un argument
to put in a claim 	 faire une demande, une réclamation
to put in for a job 	 poser sa candidature
to put off 	 repousser, retarder/décourager
to put on 	 mettre un vêtement
to put out 	 éteindre
to be put out 	 être dérangé
to be put out by something 	 se laisser démonter par…
to put up someone 	 héberger, loger quelqu’un
