to call off, to cancel 	 annuler
capital punishment/the death penalty 	 la peine capitale, la peine de mort
cash (= notes and coins) 	 de l’argent liquide
a cashcard 	 une carte bancaire
a cash desk 	 une caisse de grand magasin
a cash point 	 un distributeur automatique
to cast 	 jeter
to cast anchor 	 jeter l’ancre
to cast the blame on somebody 	 rejeter la responsabilité sur…
to cast a shadow on/over 	 jeter une ombre sur
to cast one’s eye on… 	 jeter un regard sur…
to cast a critical eye on… 	 jeter un regard critique sur…
to be cast down 	 être démoralisé
casual 	 1. désinvolte / 2. occasionnel
casualties 	 des victimes, blessés ou morts
to cater for… 	 pourvoir à…
a caterer 	 un traiteur
cattle 	 le bétail
caution 	 la prudence
cautious 	 prudent
cheap 	 1. bon marché / 2. de mauvaise qualité
to cheat 	 tricher, escroquer
to cheer 	 acclamer, applaudir
a citizen 	 un citoyen
citizenship 	 la citoyenneté
a city 	 une ville
city-dwellers 	 les citadinst
the city hall 	 la mairie
city planning 	 l’urbanisme
a civil servant 	 un fonctionnaire
a top civil servant 	 un haut fontionnaire
the civil service 	 la fonction publique, l’administration
a civilian 	 un civil
to clean 	 nettoyer
to make a clean breast of it 	 dire ce qu’on a sur la conscience
a cleaner, a charwoman 	 une femme de ménage
to cleanse 	 nettoyer
to cling to 	 s’accrocher, se cramponner à
to close down 	 fermer définitivement…
a clue 	 un indice
I don’t have a clue! 	 je n’en ai pas la moindre idée
a college 	 un établissement d’enseignement supérieur
a competitor 	 un concurrent
competitive 	 concurrentiel, compétitif
a competitive examination 	 un concours
to complete 	 compléter, achever
To complete a task 	 achever une tâche
a completion 	 un achèvement
The completion of a contract 	 l’exécution d’un contrat
comprehensive 	 général, d’ensemble
to conceal 	 cacher, dissimuler
to concede that… 	 reconnaître, concéder que…
to conduct 	 mener
to connect, to link 	 lier, relier
A connecting flight 	 un vol de correspondance
conspicuous 	 criant, qui saute aux yeux
a constituency 	 une circonscription électorale
contempt 	 scorn 
to contend with 	 lutter contre, se disputer, combattre
to contend that 	 prétendre que
a contender 	 un concurrent (sports)
A presidential contender 	 un candidat à la présidence
controversial 	 une matière à controverse
convenient 	 commode, pratique
to convey 	 1. transporter/transmettre / 2. exprimer, faire passer, communiquer
a convict 	 un prisonnier, un détenu
to convict somebody 	 déclarer coupable
a cornerstone 	 une pierre angulaire
a counterpart 	 un homologue
a course 	 un cours
A course of action 	 une ligne de conduite
in the course of time 	 au cours du temps
In due course 	 en temps utile
to let events run their course 	 laisser les événements suivre leur cours
a court 	 un tribunal
to cover up, to hush up 	 étouffer une affaire
coverage 	 un reportage
to break out 	 se déclencher (war)/s’évader
to break through	 faire une percée
A breakthrough 	 une découverte capitale,
une percée scientifique	
to break up 	 se désagréger (family, marriage)/se terminer
to bring about 	 provoquer, causer (a war, an accident)
to bring forward 	 avancer, produire
to bring out 	 faire sortir, faire ressortir, mettre en évidence
to bring up 	 élever, éduquer
to call for 	 aller chercher (the doctor)/exiger, revendiquer (strikers)
to call in/to call on someone 	 venir faire une visite
to call off 	 annuler, abandonner (investigation, research)
to call up 	 appeler, faire l’appel (candidates) ; mobiliser (soldiers) ; téléphoner
to care for 	 aimer
to carry on 	 continuer
to carry out 	 mener à bien, exécuter (plan, project)
to catch up with 	 rattraper
to close down 	 fermer définitivement
to come about 	 arriver, avoir lieu
to come across 	 rencontrer par hasard
to come along 	 accompagner/survenir
to come by 	 se procurer (a book, a record)
to come in/into 	 entrer/hériter de
to come off 	 avoir lieu, se produire, se dérouler ; se terminer, être retiré
to come out 	 être révélé (the truth)/être publié (book)/disparaître (dirt, stains)
to come to 	 revenir à soi, reprendre conscience
to come up 	 monter, apparaître à la surface/s’approcher à la hauteur de quelqu’un
to cut down 	 réduire
