an onslaught 	 un assaut, une attaque violente
to opt out 	 choisir de quitter
an opponent 	 un adversaire
an ordeal 	 une épreuve
an order 	 un ordre, une commande
the order book 	 le carnet de commandes
to oust 	 évincer, vider
an outbreak 	 une éruption, une explosion, un déclenchement
an outcast 	 un exclu, un paria
an outcome 	 une issue, un résultat
outdated 	 périmé
to outdo 	 surpasser, faire mieux que…
an outfit 	 un équipement
outgoing 	1. sortant / 2. Sociable
an outlet 	 un débouché
to outweigh 	 l’emporter sur, dépasser
an outrage 	 une atrocité
an outrage against humanity 	 un crime contre l’humanité
outrageous 	 scandaleux
outstanding 	 hors pair, exceptionnel
to outstrip 	 dépasser
overboard 	 par-dessus bord
to go overboard 	 aller trop loin/se laisser emporter
to overdo, to exaggerate 	 exagérer
to overdraw a bank account 	 mettre son compte à découvert
my bank account is overdrawn 	 je suis dans le rouge
to overhaul 	 remanier, réorganiser
an overhaul 	 révision, refonte, remaniement, réparation
overheads 	 les frais généraux
to overlap 	 se chevaucher
to overlook	 oublier, négliger
to overshadow 	 éclipser, assombrir
by some oversight 	 par mégarde
overpriced 	 trop cher
to overthrow 	 renverser
the pace 	 le rythme, la vitesse
a package tour 	 un voyage organisé
pain 	 douleur, souffrance
to go to great pains 	 se donner beaucoup de peine.
He’s a pain in the neck 	 il est casse-pieds !
paramount 	 capital
a parcel 	 un colis, un paquet
to be part and parcel of… 	 faire partie intégrante de (fig.)
a parcel bomb 	 un colis piégé
partial to, to be partial to 	 avoir un faible pour
a path 	 un chemin
a pattern 	 un schéma, un modèle
the payroll 	 l’ensemble des employés d’une société
to be on the payroll 	 faire partie du personnel
peace 	 la paix
to be at peace 	 être en paix
to peak 	 atteindre un niveau maximum
pension 	 une pension
an old-age pensioner 	 un retraité
to perceive 	 percevoir, ressentir
a percentage 	 un pourcentage
to pervade 	 envahir
pervasive 	 qui se propage
to pick up 	 se redresser
irretrievable damage 	 irréparable
an irretrievable loss 	 une perte irréparable, irrémédiable
a keen anticipation 	 une vive impatience
a keen sense of humour 	 un vif sens de l’humour
keenly awaited 	 attendu avec impatience
keenly contested (a race) 	 une course vivement contestée
a lame duck 	 un canard boiteux
a lame excuse, argument 	 … piètre, faible
a landslide victory 	 une victoire fracassante, un raz-de-marée
a leading figure 	 un personnage important
the leading part 	 le rôle vedette
a leading article 	 un éditorial
to be at the leading edge of technology 	 être à la pointe de la technologie
a looming danger 	 un danger menaçant
to loom large 	 être dangereusement menaçant
a low blow 	 un coup bas
a low-level discussion 	 à bas niveau
a low-paid job 	 mal payé
the low season 	 la morte saison
low quality goods 	 des marchandises de mauvaise qualité
to keep a low profile 	 adopter un profil bas
a major part/for the major part 	 en grande partie
a major success/a major event	
a marked jump 	 un bond considérable
a marked change 	 un changement sensible
a marked contrast 	 un contraste frappant
a massive majority 	 écrasante
on a massive scale 	 à très grande échelle
a mock examination 	 un examen blanc
a momentous decision 	 une décision capitale
a narrow escape 	 to have a narrow escape 
narrow-minded 	 à l’esprit étroit
a nasty trick 	 un sale tour
a nasty mess 	 une sacrée pagaille
a nasty temper 	 un sale caractère
in the nick of time 	 juste à temps, à la dernière seconde…
