to be / to keep abreast of something, to be aware of 	 se tenir au courant de…
academic 	 1. universitaire. 2. théorique
an academic debate 	 une discussion toute théorique
an ace 	 un as
to keep an ace up one’s sleeve 	 garder un atout en réserve (fig.)
to hold all the aces 	 avoir tous les atouts
an ace driver 	 un as du volant
acid rain 	 les pluies acides
an act of Parliament, an act of Congress 	 une loi
an act of God 	 une catastrophe naturelle
business acumen 	 le sens des affaires
adamant 	 obstiné
an address 	 1. une adresse. 2. un discours officiel
to address someone 	 s’adresser à…
to admit, to acknowledge 	 admettre
admittance 	 droit d’entrée, admission
no admittance 	 accès interdit
affirmative action 	 discrimination positive (politique américaine)
the aftermath 	 les suites, les séquelles
an agenda 	 un ordre du jour
ailing 	 souffrant
alimony 	 une pension alimentaire (en cas de divorce)
to alleviate 	 soulager, alléger (pain, difficulties)
aloof, uninvolved 	 distant, qui ne se sent pas impliqué
an ambush 	 une embuscade
appalling 	 effroyable
apt 	 pertinent
an array 	 une série, un vaste choix
asbestos 	 l’amiante
an assembly line 	 une chaîne de montage (dans une usine)
astute 	 fin, astucieux
attrition 	 l’usure
a war of attrition 	 une guerre d’usure
an auction 	 une vente aux enchères
an audience 	 un public
to avert a danger 	 éviter, prévenir
an award 	 une récompense, un prix
an axe 	 une hache, un couperet
to axe 	 supprimer
to axe jobs, to slash jobs 	 supprimer des emplois
to axe expenditure 	 faire des coupes sombres dans les dépenses
a ballot 	 un vote, un scrutin
A ballot box 	 une urne
A ballot paper 	 un bulletin de vote
to bamboozle, to con, to hoodwink 	 arnaquer, embobiner
barracks 	 une caserne
barracking 	 du chahut
barren 	 désert, stérile
a bash 	 un coup
to barter, to swap 	 faire l’échange, faire du troc
a batch 	 une série, une ribambelle, une fournée (souvent péjoratif)
to batter 	 battre, maltraiter, martyriser
to beguile, to swindle 	 duper
a bear 	 un ours
a bear market 	 un marché en repli
to beget 	 engendrer
a bench 	 un banc
A backbencher 	 un député de base à la Chambre des communes
to bark up the wrong tree 	 se tromper d’adversaire
to be the odd man out 	 faire bande à part, se désolidariser
to be strapped for cash 	 être à court d’argent
to be hand in glove with somebody 	 être de mêche avec…
to be in the doldrums 	 être en crise, dans une mauvaise passe
to be on one’s last legs 	 être au bout du rouleau, à l’article de la mort
to be at a loss 	 être perplexe, ne pas savoir que faire
to be on the verge of 	 être sur le point de
to be on a par with 	 être comparable avec, être l’égal de…
to be out on a limb 	 être isolé, se trouver dans une situation difficile
to be a pain in the neck 	 être casse-pieds
to be built on sand 	 être un château de cartes
to bear someone a grudge 	 en vouloir à…
to beat about the bush 	 tourner autour du pot
to bring rich pickings 	 rapporter gros
